0000000000000000000000000000000000000000000000000000000000000000000000000000000000000000000000000000000000000000BBBBBBBBBB00000000000000000000000000000BBBB0000000000000000000000BB000000BBBBBBBB00000000000000000000000000000000000000000000000000000000B0B0B0B0B00000000000BBBBBBBB0000000BBBBB000000000000000000000000000000000000000000000000000000000000000000000000000000000000000000000000000000000BBBB00000000000000000000000000000000000000000000000000000000000000D000
0000000000000000000000000000000000000000000000000000000000000000000000000000000000000000000000000000000000000000555555555500000000000000000000000000000BBBB000000000000000000000055000000555555550000000000000000000000000000000000000000000000000000000000000000000000000000E0E0E0E0000000055555000000000000000000000000000000000000000000000000000000000000000000000000000000000000000000000000000000000E0E0000000000000000000000000000000000000000000000000000000500000000000
00000000000000000000000000000000000000000000000000000000000000000000000000000000000000000000000000000000500000000000000000000000000000000000000000000000000000000000000000B0B0B0B00000000000000000000000000000000000000000000000000B0B000000B0B00000000E0E0E0E0E0E000000500005555555500000000000000000S0000000000000000000000000000000000000000000000000000000000000000000000000000000000000000000000000005555000000000000E0E000000000000000000000000000000000000005500000055550
0000000000000000000000000000000000000000000000000000000000000000000000000000000000000000000000000000000500000000000000000000000000000000000000000000000000000000000000000000000000000000000000000000000000000000000000000000000000000000000000000000001111111111111100000000000000000000000000000000055500000000000000000000000000000000000000000000000000000000000000000000000000F0000000000F00000000000000BBBB0000000000555500000000000000000000000000000000000055500000000000
00000000000000000000000000000000000000000000000000000000000000000000000000000000000000000000000000000050000000000000BBBB0000000000000000000000000000000000000000000000000E0E0E0E000000000000000000000000000000000000000000000000E0E0E0E00HH0E0E000000022222222222222000000000000000000000000000000000000000000000000000000000000000000000000000000000000000000E0000E0000E0000E0000000E000E000000E00E00E00E00BBBB0000000000000000000000000000E0E0000050000E0E0E0E05555E0E000E0E00
000000000000000000000000000000000000000000B0B0B0B0000000000000000000B0B0B0B00000000000000000000000000000000000000000BBBB0000000000000000000000000E0E0E0E0E0000000000000005555555500000000000000000000000000000000000000000000000111111111111111100000000000000000000000000000000000000000000000000000000000000000000000000000000000000000000000000000000000011111111111111111111111111111111111111111111111111111111100000000055555555000000555500000000011111111111111111111110
00000000000000000000000000000000000000000000000000000000000000000000000000000000000000000000000000000000000000000000BBBB000000000000000000000000055555555550000000000000000000000000000000000000000000000000000000000000000000002222222222222222000000000000000000000000000000B00B0000000000000000000000000000000000000000000000000000000000000000000000000022222222222222222222222222222222222222222222222222222222200000000000000000000000000000000000022222222222222222222220
00000000000000000000000000000000000000000555555555000000000000000000B0B0B0B000000000000000000000000000F000000F000000BBBB000000000E0E0000000E0E00000000000000000BBBBBB00000000000000000C000000006666000000000000000000000000000000000B00B000000000000000000000000000000000000B000000B000000000000000000000000000000000000B00B00B00B00B00000000000005555000000000000000000000000000000000000000000000000000000000000005HHHHHHHHHHHHHHHHHHHHHHHHHHHHHHHHHHHH50000000000000000000000
00000000000000000000000000000000000000000000000000000000000000000000E000E000E00HHH0E00E00HHH00E0E0E0E000E0E0000E0E0E0E0E0E0000000555500000055550000000000000000555555000000000000000000000000006A06000000000000F00000000F000000000B0000000B00000000000000000G000000G000000B0000000000B00000000000000000000000000000000000000000000000000000000000000000000000000000000000000000000000000000000BB000000000000000000005555555555555555555555555555555555555500000000000000000000BB
000000000000000000000000000000000000000000000000000000000000000E0E0111111111111111111155555555555511111111111111111111111110000000000000000000000000000000000000000000000000000000000E0E0E0E00060060000E0E0E0E000E000E0000000E0000E0000E0000E0E0E0E0E0E0E000000000000E0E0E0E0E0E0E0E0E00000HHHH00E000E000HHHH00E0E0E0E0E0E0E0E0E0000000E0E000000000000000000000000000B0B0B0B0B000000000000000B00B0000000000000000000000000000000000B000B000B000B000B00000000000000000000000000BB
0000000B0B0B0B0000000000F0000000F000000000B0B0B0B0000000000E0E011112222222222222222222000000000000222222222222222222222222200000000000000000000000000000000000000000000000000000011111111111111111111111111111111111111111111111111111111111111111111111111111111111111111111111111111111111111111111111111111111111111111111111111111111111100000000000000000000000000000000000000000000000B0000B0000000000000000000000000000000000000000000000000000000000000000000000000000BB
E0E0E0E0E0E0E0E0E0E0E00000E00E00000E0E0E0E0E0E0E0E000E00E001111222222222222222222222220000000000002222222222222222222222222000000000000000000000000000000000000000000000000000000222222222222222222222222222222222222222222222222222222222222222222222222222222222222222222222222222222222222222222222222222222222222222222222222222222222222000000000000000000000000E0E0E0E000000000000000000E0E0E0E00000000005500000000000000E00E00E00E00E00E00E00E0000000HHH0E0E0E00HHH00E0E0
11111111111111111111111111111111111111111111111111111111111222222222222222222222222222000000000000222222222222222222222222200000000000000000000000000000000000000000000000000000022222222222222222222222222222222222222222222222222222222222222222222222222222222222222222222222222222222222222222222222222222222222222222222222222222222222200005500000555550000000111111111100000000000000111111111100000000000000000000001111111111111111111111111111111111111111111111111111
22222222222222222222222222222222222222222222222222222222222222222222222222222222222222000000000000222222222222222222222222200000000000000000000000000000000000000000000000000000022222222222222222222222222222222222222222222222222222222222222222222222222222222222222222222222222222222222222222222222222222222222222222222222222222222222200005500000000000000000222222222200000000000000222222222200000000000000000000002222222222222222222222222222222222222222222222222222