0000000000000000000000000000000000000
0000000000000000000000000000000000000
0000000000000000000000000000000000000
0000000000000000000000000000000000000
0000000000000000000000000000000000000
000000BBB0000000000000000000000000000
000000BBB0000000000000000000000000000
000000BBB0000000000000000000000000000
0000000000000000000000000000000000000
0000000000000000000000000000000000000
0000000900000000000000000000000000000
000000000000000P000000000p00000000000
1111111111111110000000000000000000000
222222222222222WWWWWWWWWWWWWWWWWWWWWW